NO          textures/north.xpm
SO          textures/south.xpm

C   190,254,23
EA          textures/south.xpm

F              0,5,0

WE          textures/south.xpm

111
10111111
10111101
10111111111111
10000000000001
1111111111110111
        1E0111
        1110111
        1111011
        101001
        111111